0x1 0 0 1 0x0 0
1314 -3 2 0 0x0 1
1314 2 -1 0 0x0 1
1314 2 -3 0 0x0 1
1314 3 -2 0 0x0 1
1307 1 0 0 0x0 1
1314 3 3 0 0x0 1
1307 4 -2 0 0x0 1
1314 -2 3 0 0x0 1
1314 -1 3 0 0x0 1
1307 4 4 0 0x0 1
1305 4 3 0 0x0 1
1308 4 1 0 0x0 1
1314 4 2 0 0x0 1
1314 -2 1 0 0x0 1
1314 2 -2 0 0x0 1
1307 -1 1 0 0x0 1
1307 2 0 0 0x0 1
1305 4 -3 0 0x0 1
1314 0 -2 0 0x0 1
1307 -1 0 0 0x0 1
1314 3 2 0 0x0 1
1314 -1 2 0 0x0 1
1306 1 1 0 0x0 1
1306 -3 1 0 0x0 1
1305 -3 4 0 0x0 1
1307 0 -3 0 0x0 1
1308 0 1 0 0x0 1
1305 3 -3 0 0x0 1
1306 0 0 0 0x0 1
1314 -3 -1 0 0x0 1
1308 -2 -3 0 0x0 1
1314 -2 -2 0 0x0 1
1308 0 2 0 0x0 1
1314 2 3 0 0x0 1
1314 2 2 0 0x0 1
1305 0 -1 0 0x0 1
1307 2 1 0 0x0 1
1306 -3 -2 0 0x0 1
1307 -3 -3 0 0x0 1
1314 -1 -3 0 0x0 1
1306 -2 4 0 0x0 1
1308 -3 3 0 0x0 1
1308 1 2 0 0x0 1
1307 3 4 0 0x0 1
1305 -3 0 0 0x0 1
1314 -2 -1 0 0x0 1
1314 -2 0 0 0x0 1
1314 -2 2 0 0x0 1
1314 2 4 0 0x0 1
1314 -1 4 0 0x0 1
1307 1 -1 0 0x0 1
1314 1 -2 0 0x0 1
1306 1 -3 0 0x0 1
1308 0 4 0 0x0 1
1314 0 3 0 0x0 1
1305 4 0 0 0x0 1
1314 4 -1 0 0x0 1
1314 3 1 0 0x0 1
1314 3 0 0 0x0 1
1314 3 -1 0 0x0 1
1314 -1 -2 0 0x0 1
1314 -1 -1 0 0x0 1
1307 1 4 0 0x0 1
1314 1 3 0 0x0 1
