0x1 0 0 1 0x0 0
1314 0 -2 0 0x0 1
1316 0 -3 0 0x0 1
1307 -1 4 0 0x0 1
1315 -1 3 0 0x0 1
1316 -1 2 0 0x0 1
1307 -1 1 0 0x0 1
1307 -1 0 0 0x0 1
1315 -1 -1 0 0x0 1
1313 -1 -2 0 0x0 1
1307 -1 -3 0 0x0 1
1314 -2 4 0 0x0 1
1307 -2 3 0 0x0 1
1315 -2 2 0 0x0 1
1313 -2 1 0 0x0 1
1314 -2 0 0 0x0 1
1313 -2 -1 0 0x0 1
1307 -2 -2 0 0x0 1
1313 -2 -3 0 0x0 1
1316 -3 4 0 0x0 1
1314 -3 3 0 0x0 1
1307 -3 2 0 0x0 1
1314 -3 1 0 0x0 1
1313 -3 0 0 0x0 1
1307 -3 -1 0 0x0 1
1313 -3 -2 0 0x0 1
1313 -3 -3 0 0x0 1
1307 0 -1 0 0x0 1
1314 0 0 0 0x0 1
1313 0 1 0 0x0 1
1307 0 2 0 0x0 1
1316 0 3 0 0x0 1
1313 0 4 0 0x0 1
1315 1 -3 0 0x0 1
1315 1 -2 0 0x0 1
1307 1 -1 0 0x0 1
1314 1 0 0 0x0 1
1316 1 1 0 0x0 1
1307 1 2 0 0x0 1
1314 1 3 0 0x0 1
1313 1 4 0 0x0 1
1307 2 -3 0 0x0 1
1315 2 -2 0 0x0 1
1316 2 -1 0 0x0 1
1307 2 0 0 0x0 1
1307 2 1 0 0x0 1
1313 2 2 0 0x0 1
1315 2 3 0 0x0 1
1307 2 4 0 0x0 1
1314 3 -3 0 0x0 1
1307 3 -2 0 0x0 1
1315 3 -1 0 0x0 1
1315 3 0 0 0x0 1
1314 3 1 0 0x0 1
1315 3 2 0 0x0 1
1307 3 3 0 0x0 1
1314 3 4 0 0x0 1
1314 4 -3 0 0x0 1
1316 4 -2 0 0x0 1
1307 4 -1 0 0x0 1
1313 4 0 0 0x0 1
1314 4 1 0 0x0 1
1307 4 2 0 0x0 1
1316 4 3 0 0x0 1
1316 4 4 0 0x0 1
