1315 -3 1 0 0x0 1
1313 -3 2 0 0x0 1
1314 -3 -2 0 0x0 1
1315 -3 -3 0 0x0 1
1314 -3 -1 0 0x0 1
1315 -3 0 0 0x0 1
1313 -3 4 0 0x0 1
1314 -3 3 0 0x0 1
1314 -2 -3 0 0x0 1
1314 -2 -2 0 0x0 1
1314 -2 -1 0 0x0 1
1313 -2 0 0 0x0 1
1313 -2 1 0 0x0 1
1313 -2 2 0 0x0 1
1313 -2 3 0 0x0 1
1314 -2 4 0 0x0 1
1315 -1 -3 0 0x0 1
1314 -1 -2 0 0x0 1
1313 -1 -1 0 0x0 1
1315 -1 0 0 0x0 1
1315 -1 1 0 0x0 1
1314 -1 2 0 0x0 1
1314 -1 3 0 0x0 1
1313 -1 4 0 0x0 1
1315 0 -3 0 0x0 1
1313 0 -2 0 0x0 1
1314 0 -1 0 0x0 1
1313 0 0 0 0x0 1
1313 0 1 0 0x0 1
1313 0 2 0 0x0 1
1315 0 3 0 0x0 1
1314 0 4 0 0x0 1
1314 1 -3 0 0x0 1
1313 1 -2 0 0x0 1
1313 1 -1 0 0x0 1
1315 1 0 0 0x0 1
1313 1 1 0 0x0 1
1313 1 2 0 0x0 1
1314 1 3 0 0x0 1
1314 1 4 0 0x0 1
1313 2 -3 0 0x0 1
1313 2 -2 0 0x0 1
1314 2 -1 0 0x0 1
1313 2 0 0 0x0 1
1314 2 1 0 0x0 1
1313 2 2 0 0x0 1
1314 2 3 0 0x0 1
1315 2 4 0 0x0 1
1315 3 -3 0 0x0 1
1314 3 -2 0 0x0 1
1314 3 -1 0 0x0 1
1315 3 0 0 0x0 1
1314 3 1 0 0x0 1
1314 3 2 0 0x0 1
1314 3 3 0 0x0 1
1314 3 4 0 0x0 1
1315 4 -3 0 0x0 1
1314 4 -2 0 0x0 1
1313 4 -1 0 0x0 1
1314 4 0 0 0x0 1
1314 4 1 0 0x0 1
1313 4 2 0 0x0 1
1315 4 3 0 0x0 1
1313 4 4 0 0x0 1