0x1 0 0 1 0x0 0
1183 2 3 0 0x0 1
1181 -1 1 0 0x0 1
1184 4 1 0 0x0 1
1183 -3 -3 0 0x0 1
1184 4 0 0 0x0 1
1181 1 3 0 0x0 1
1183 1 2 0 0x0 1
1183 2 -3 0 0x0 1
1181 -3 -1 0 0x0 1
1181 4 4 0 0x0 1
1184 -3 1 0 0x0 1
1184 1 4 0 0x0 1
1184 -3 0 0 0x0 1
1181 -3 -2 0 0x0 1
1181 4 2 0 0x0 1
1181 4 3 0 0x0 1
1181 2 0 0 0x0 1
1183 2 1 0 0x0 1
1184 2 2 0 0x0 1
1181 2 -2 0 0x0 1
1184 2 -1 0 0x0 1
1184 -1 2 0 0x0 1
1184 0 -3 0 0x0 1
1181 -1 4 0 0x0 1
1181 0 -2 0 0x0 1
1183 0 -1 0 0x0 1
1181 0 0 0 0x0 1
1183 0 1 0 0x0 1
1183 0 2 0 0x0 1
1181 0 3 0 0x0 1
1184 0 4 0 0x0 1
1183 -1 3 0 0x0 1
1184 1 -3 0 0x0 1
1181 1 -2 0 0x0 1
1183 1 -1 0 0x0 1
1181 1 0 0 0x0 1
1181 1 1 0 0x0 1
1181 -3 4 0 0x0 1
1183 -2 -3 0 0x0 1
1183 2 4 0 0x0 1
1181 3 -3 0 0x0 1
1183 3 -2 0 0x0 1
1181 3 -1 0 0x0 1
1181 3 0 0 0x0 1
1181 3 1 0 0x0 1
1183 3 2 0 0x0 1
1183 3 3 0 0x0 1
1183 3 4 0 0x0 1
1183 4 -3 0 0x0 1
1181 4 -2 0 0x0 1
1183 -3 2 0 0x0 1
1183 -3 3 0 0x0 1
1181 4 -1 0 0x0 1
1183 -2 -2 0 0x0 1
1183 -2 -1 0 0x0 1
1181 -2 0 0 0x0 1
1181 -2 1 0 0x0 1
1181 -2 2 0 0x0 1
1181 -2 3 0 0x0 1
1181 -2 4 0 0x0 1
1183 -1 -3 0 0x0 1
1181 -1 -2 0 0x0 1
1184 -1 -1 0 0x0 1
1181 -1 0 0 0x0 1
