0x1 0 0 1 0x0 0
1310 -3 -2 0 0x0 1
1311 -3 -3 0 0x0 1
1310 4 4 0 0x0 1
1310 4 3 0 0x0 1
1309 4 2 0 0x0 1
1310 4 1 0 0x0 1
1311 4 0 0 0x0 1
1309 4 -1 0 0x0 1
1310 4 -2 0 0x0 1
1310 4 -3 0 0x0 1
1309 3 4 0 0x0 1
1309 3 3 0 0x0 1
1310 3 2 0 0x0 1
1311 3 1 0 0x0 1
1311 3 0 0 0x0 1
1309 3 -1 0 0x0 1
1310 3 -2 0 0x0 1
1311 3 -3 0 0x0 1
1310 2 4 0 0x0 1
1309 2 3 0 0x0 1
1310 2 2 0 0x0 1
1310 2 1 0 0x0 1
1309 2 0 0 0x0 1
1311 2 -1 0 0x0 1
1309 2 -2 0 0x0 1
1310 2 -3 0 0x0 1
1310 1 4 0 0x0 1
1310 1 3 0 0x0 1
1309 1 2 0 0x0 1
1309 1 1 0 0x0 1
1311 1 0 0 0x0 1
1309 1 -1 0 0x0 1
1309 1 -2 0 0x0 1
1311 1 -3 0 0x0 1
1311 0 4 0 0x0 1
1310 0 3 0 0x0 1
1311 0 2 0 0x0 1
1310 0 1 0 0x0 1
1311 0 0 0 0x0 1
1311 0 -1 0 0x0 1
1309 0 -2 0 0x0 1
1311 0 -3 0 0x0 1
1310 -1 4 0 0x0 1
1311 -1 3 0 0x0 1
1311 -1 2 0 0x0 1
1311 -1 1 0 0x0 1
1309 -1 0 0 0x0 1
1310 -1 -1 0 0x0 1
1310 -1 -2 0 0x0 1
1310 -1 -3 0 0x0 1
1311 -2 4 0 0x0 1
1311 -2 3 0 0x0 1
1309 -2 2 0 0x0 1
1310 -2 1 0 0x0 1
1310 -2 0 0 0x0 1
1310 -2 -1 0 0x0 1
1311 -2 -2 0 0x0 1
1310 -2 -3 0 0x0 1
1311 -3 4 0 0x0 1
1309 -3 3 0 0x0 1
1309 -3 2 0 0x0 1
1311 -3 1 0 0x0 1
1311 -3 0 0 0x0 1
1309 -3 -1 0 0x0 1