0x1 0 0 1 0x0 0
1279 -2 -2 0 0x0 1
1278 -2 1 0 0x0 1
1279 -2 0 0 0x0 1
1277 -2 -1 0 0x0 1
1278 -2 2 0 0x0 1
1278 -2 3 0 0x0 1
1278 -2 4 0 0x0 1
1278 -3 -3 0 0x0 1
1279 -3 -2 0 0x0 1
1276 -3 -1 0 0x0 1
1276 -3 0 0 0x0 1
1279 -3 1 0 0x0 1
1278 -3 2 0 0x0 1
1278 -3 3 0 0x0 1
1279 -3 4 0 0x0 1
1276 -2 -3 0 0x0 1
1279 4 1 0 0x0 1
1277 4 4 0 0x0 1
1276 4 -2 0 0x0 1
1279 4 -3 0 0x0 1
1279 4 2 0 0x0 1
1277 4 3 0 0x0 1
1279 3 4 0 0x0 1
1279 4 0 0 0x0 1
1279 4 -1 0 0x0 1
1279 -1 -3 0 0x0 1
1277 -1 -2 0 0x0 1
1277 -1 -1 0 0x0 1
1279 -1 0 0 0x0 1
1278 -1 1 0 0x0 1
1279 -1 2 0 0x0 1
1276 -1 3 0 0x0 1
1279 -1 4 0 0x0 1
1276 0 -3 0 0x0 1
1276 0 -2 0 0x0 1
1278 0 -1 0 0x0 1
1279 0 0 0 0x0 1
1277 0 1 0 0x0 1
1279 0 2 0 0x0 1
1278 0 3 0 0x0 1
1276 0 4 0 0x0 1
1278 1 -3 0 0x0 1
1276 1 -2 0 0x0 1
1278 1 -1 0 0x0 1
1279 1 0 0 0x0 1
1276 1 1 0 0x0 1
1278 1 2 0 0x0 1
1277 1 3 0 0x0 1
1278 1 4 0 0x0 1
1277 2 -3 0 0x0 1
1276 2 -2 0 0x0 1
1279 2 -1 0 0x0 1
1279 2 0 0 0x0 1
1278 2 1 0 0x0 1
1278 2 2 0 0x0 1
1278 2 3 0 0x0 1
1276 2 4 0 0x0 1
1276 3 -1 0 0x0 1
1276 3 0 0 0x0 1
1279 3 1 0 0x0 1
1278 3 2 0 0x0 1
1279 3 3 0 0x0 1
1276 3 -3 0 0x0 1
1278 3 -2 0 0x0 1
